{
    "current_map": "village",
    "maps": [
        {
        "name": "village",
        "type": "safe_zone",
        "width": 38,
        "height": 23,
        "tiles": [
          [ 6, 7, 7, 7, 7, 7, 7, 7, 7, 7, 7, 7, 7, 7, 7, 7, 7, 7, 7, 7, 7, 7, 7, 7, 7, 7, 7, 7, 7, 7, 7, 7, 7, 7, 7, 7, 7, 8],
          [ 9,10,10,10,10,10,10,10,10,10,10,10,10,10,10,10,10,10,10,10,10,10,10,10,10,10,10,10,10,10,10,10,10,10,10,10,10,11],
          [ 9,10,10,10,10,10,10,10,13,13,13,13,13,13,13,13,13,13,13,13,13,13,13,13,13,13,13,13,13,13,13,13,13,13,13,13,13,14],
          [ 9,10,10,10,10,10,10,11,16,16,16,16,16,16,16,16,16,16,16,16,16,16,16,16,16,16,16,16,16,16,16,16,16,16,16,16,16,17],
          [ 9,10,10,10,10,10,10,11,19,19,19,19,19,19,19,19,19,19,19,19,19,19,19,19,19,19,19,19,19,19,19,19,19,19,19,19,19,20],
          [ 9,10,10,10,10,10,10,11,22,22,22,22,22,22,22,22,22,22,22,22,22,22,22,22,22,22,22,22,22,22,22,22,22,22,22,22,22,23],
          [ 9,10,10,10,10,10,10,11, 0, 0, 0, 0, 0, 0, 0, 0, 0, 0, 0, 0, 0, 0, 0, 0, 0, 0, 0, 0, 0, 0, 0, 0, 0, 0, 0, 0, 0, 0],
          [ 9,10,10,10,10,10,10,11, 0, 0, 0, 0, 0, 0, 0, 0, 0, 0, 0, 0, 0, 0, 0, 0, 0, 0, 0, 0, 0, 0, 0, 0, 0, 0, 0, 0, 0, 0],
          [ 9,10,10,10,10,10,10,11, 0, 0, 0, 0, 0, 0, 0, 0, 0, 0, 0, 0, 0, 0, 0, 0, 0, 0, 0, 0, 0, 0, 0, 0, 0, 0, 0, 0, 0, 0],
          [ 9,10,10,10,10,10,10,11, 0, 0, 0, 0, 0, 0, 0, 0, 0, 0, 0, 0, 0, 0, 0, 0, 0, 0, 0, 0, 0, 0, 0, 0, 0, 0, 0, 0, 0, 0],
          [ 9,10,10,10,10,10,10,11, 0, 0, 0, 0, 0, 0, 0, 0, 0, 0, 0, 0, 0, 0, 0, 0, 0, 0, 0, 0, 0, 0, 0, 0, 0, 0, 0, 0, 0, 0],
          [ 9,10,10,10,10,10,10,11, 0, 0, 0, 0, 0, 0, 0, 0, 0, 0, 0, 0, 0, 0, 0, 0, 0, 0, 0, 0, 0, 0, 0, 0, 0, 0, 0, 0, 0, 0],
          [12,13,13,13,13,13,13,14, 0, 0, 0, 0, 0, 0, 0, 0, 0, 0, 0, 0, 0, 0, 0, 0, 0, 0, 0, 0, 0, 0, 0, 0, 0, 0, 0, 0, 0, 0],
          [15,16,16,16,16,16,16,17, 0, 0, 0, 0, 0, 0, 0, 0, 0, 0, 0, 0, 0, 0, 0, 0, 0, 0, 0, 0, 0, 0, 0, 0, 0, 0, 0, 0, 0, 0],
          [18,19,19,19,19,19,19,20, 0, 0, 0, 0, 0, 0, 0, 0, 0, 0, 0, 0, 0, 0, 0, 0, 0, 0, 0, 0, 0, 0, 0, 0, 0, 0, 0, 0, 0, 0],
          [21,22,22,22,22,22,22,23, 0, 0, 0, 0, 0, 0, 0, 0, 0, 0, 0, 0, 0, 0, 0, 0, 0, 0, 0, 0, 0, 0, 0, 0, 0, 0, 0, 0, 0, 0],
          [ 0, 0, 0, 0, 0, 0, 0, 0, 0, 0, 0, 0, 0, 0, 0, 0, 0, 0, 0, 0, 0, 0, 0, 0, 0, 0, 0, 0, 0, 0, 0, 0, 0, 0, 0, 0, 0, 0],
          [ 0, 0, 0, 0, 0, 0, 0, 0, 0, 0, 0, 0, 0, 0, 0, 0, 0, 0, 0, 0, 0, 0, 0, 0, 0, 0, 0, 0, 0, 0, 0, 0, 0, 0, 0, 0, 0, 0],
          [ 0, 0, 0, 0, 0, 0, 0, 0, 0, 0, 0, 0, 0, 0, 0, 0, 0, 0, 0, 0, 0, 0, 0, 0, 0, 0, 0, 0, 0, 0, 0, 0, 0, 0, 0, 0, 0, 0],
          [ 0, 0, 0, 0, 0, 0, 0, 0, 0, 0, 0, 0, 0, 0, 0, 0, 0, 0, 0, 0, 0, 0, 0, 0, 0, 0, 0, 0, 0, 0, 0, 0, 0, 0, 0, 0, 0, 0],
          [ 0, 0, 0, 0, 0, 0, 0, 0, 0, 0, 0, 0, 0, 0, 0, 0, 0, 0, 0, 0, 0, 0, 0, 0, 0, 0, 0, 0, 0, 0, 0, 0, 0, 0, 0, 0, 0, 0],
          [ 0, 0, 0, 0, 0, 0, 0, 0, 0, 0, 0, 0, 0, 0, 0, 0, 0, 0, 0, 0, 0, 0, 0, 0, 0, 0, 0, 0, 0, 0, 0, 0, 0, 0, 0, 0, 0, 0],
          [ 0, 0, 0, 0, 0, 0, 0, 0, 0, 0, 0, 0, 0, 0, 0, 0, 0, 0, 0, 0, 0, 0, 0, 0, 0, 0, 0, 0, 0, 0, 0, 0, 0, 0, 0, 0, 0, 0]
      ],      
        "objects": [
          {
            "type": "item",
            "id": 1,
            "x": 90,
            "y": 15
          },
          {
            "type": "house",
            "id": 1,
            "x": 22,
            "y": 7.5
          }
        ],
        "triggers": [
          {
            "event": "change_map",
            "x": 24,
            "y": 11,
            "target_map": "house",
            "start_pos": {
              "x": 2,
              "y": 2
            }
          }
        ],
        "properties": {
          "allow_combat": false,
          "background_music": "village_theme.mp3"
        }
      },{
        "name": "house",
        "type": "safe_zone",
        "width": 38,
        "height": 23,
        "tiles": [
          [1,1,1,1,1,1,1,1,1,1],
          [1,0,0,0,0,0,0,0,0,1],
          [1,0,0,0,0,0,0,0,0,1],
          [1,0,0,0,0,0,0,0,0,1],
          [1,0,0,0,0,0,0,0,0,1],
          [1,0,0,0,0,0,0,0,0,1],
          [1,0,0,0,0,0,0,0,0,1],
          [1,0,0,0,0,0,0,0,0,1],
          [1,0,0,0,0,0,0,0,0,1],
          [1,1,1,1,1,1,1,1,1,1]
      ],      
        "objects": [
          {
            "type": "item",
            "id": 1,
            "x": 90,
            "y": 15
          },
          {
            "type": "house",
            "id": 1,
            "x": 22,
            "y": 7.5
          }
        ],
        "triggers": [
          {
            "event": "change_map",
            "x": 24,
            "y": 11,
            "target_map": "house",
            "start_pos": {
              "x": 2,
              "y": 2
            }
          }
        ],
        "properties": {
          "allow_combat": false,
          "background_music": "village_theme.mp3"
        }
      }
      ]
}